50 50
00000000101000100010010010010100001000001000001000
0X000000000011000000000000001100010010000000001011
00010001101010001001000000001100000000010100001000
00000010010110001001000100100100000101000110100000
00X10000000000000000010010000000001000000000001000
XXX0X101000001000000000000010010010100000000000011
00000001000100000000000000001100000000001000000011
X0001000000000010000100001101000000000011000001000
00000110001000000110011100001000100101000010000010
X0X00010000100001000000000100000001000000000000011
00000010011110000100000000001000000000010011101110
00000000111000000010100100000000000001100000011000
00000000000100001010100000000000100000000010010010
00000010000000000100010010110010000000000000000011
00000000000001100000011001001100101000000001001000
00000100011000010000000001000000000001100000011000
X1100000000110000100000000011100100001000000000001
11110100000000000000000001010100000100001000011000
00000100010000011111010001000001000010110011001000
00000100000001000100000000100010100111000000000001
00000010000000000100100000100000100000011000001000
00000100000000000000001011000010001100000000000010
10000100001010001110010000100001000001010000000000
11010000010000000000000100100000000000101010000000
11001001010001010000010100000100100000111000000000
01100100100001000000000100000000011000100110000110
10010000101000100010001100000000000010001001000100
00000000100000000011000100000001010001100000000000
00000010000000000100000000000000100000110101000001
00000000011101000000110100000001111110010100000000
00100110000001000000100001000001100000100001011010
00010111000100001101110010000000000000100011010000
00000101000000010101011000011000000100001000000000
00100000010000000000011010000000000000000000000000
10100000000000000100110100100000000000000000100100
01001000000010000100001100000100000010000110001001
00000001000000000000000000001010010000100000010000
01010011000010000000001000000011100001000000000000
01000000000000101000010100000010101101100010000100
10000001000101000000000000000010000000000000110000
00100000001000000000100010000010001001100000000000
11000101110001000011011000000000111000000000000000
00010000000100000000001100000100000000001010000000
00000100100000101010100000100011000110000100010000
00010000100010100000101000000001010110000000000001
00000100000000010001000000000000000000000000000000
00000101000000000001001000000000000000000000001001
00000001100000000010000110000010000001001000000010
00000000010001100100000100010000001100010100000000
00001010000100001010000000000000010000001010000100