20 20
00000011000000100100
X0000100000000010100
00X00100100000100101
00010100000000000110
00001000000000000000
00000110100100100001
0XX00010010000010000
0X000000000100000000
XX0X1100001100101000
00X00000000001000101
00000000100000000000
0X001000010000000001
00000100001000000000
00000001010000000010
00X00100000001000100
00000000000100011001
00XX0000100000000010
X0000000001000010000
X000X000000010110000
00100000010000000000